1_00000000_00000000
0_00000000_00000000
0_00000000_00000001
1_00000000_00000000
0_00000000_00000010
1_00000000_00000000
0_00000000_00000011
1_00000000_00000000
0_00000000_00000100
1_00000000_00000000
0_00000000_00000101
1_00000000_00000000
0_00000000_00000110
0_00000000_00000111
0_00000000_00001000
0_00000000_00001001
1_00000000_00000000
0_00000000_00001010
1_00000000_00000000
1_00000000_00000000
0_00000000_00001011
1_00000000_00000000
1_00000000_00000000
0_00000000_00001100
0_00000000_00001101
1_00000000_00000000
1_00000000_00000000
0_00000000_00001110
1_00000000_00000000
1_00000000_00000000
1_00000000_00000000
0_00000000_00001111
0_00000000_00010000
1_00000000_00000000
1_00000000_00000000
1_00000000_00000000
0_00000000_00010001
1_00000000_00000000
0_00000000_00010010
0_00000000_00010011
0_00000000_00010100
0_00000000_00010101
0_00000000_00010110
1_00000000_00000000
1_00000000_00000000
1_00000000_00000000
0_00000000_00010111
0_00000000_00011000
1_00000000_00000000
0_00000000_00011001
0_00000000_00011010
1_00000000_00000000
0_00000000_00011011
1_00000000_00000000
1_00000000_00000000
0_00000000_00011100
0_00000000_00011101
0_00000000_00011110
0_00000000_00011111
0_00000000_00100000
0_00000000_00100001
0_00000000_00100010
0_00000000_00100011
0_00000000_00100100
0_00000000_00100101
0_00000000_00100110
0_00000000_00100111
0_00000000_00101000
0_00000000_00101001
0_00000000_00101010
0_00000000_00101011
0_00000000_00101100
0_00000000_00101101
1_00000000_00000000
0_00000000_00101110
0_00000000_00101111
0_00000000_00110000
0_00000000_00110001
0_00000000_00110010
0_00000000_00110011
0_00000000_00110100
0_00000000_00110101
0_00000000_00110110
0_00000000_00110111
0_00000000_00111000
0_00000000_00111001
0_00000000_00111010
0_00000000_00111011
0_00000000_00111100
0_00000000_00111101
0_00000000_00111110
0_00000000_00111111
0_00000000_01000000
0_00000000_01000001
0_00000000_01000010
0_00000000_01000011
0_00000000_01000100
0_00000000_01000101
0_00000000_01000110
0_00000000_01000111
1_00000000_00000000
0_00000000_01001000
1_00000000_00000000
0_00000000_01001001
1_00000000_00000000
1_00000000_00000000
1_00000000_00000000
0_00000000_01001010
0_00000000_01001011
0_00000000_01001100
0_00000000_01001101
0_00000000_01001110
0_00000000_01001111
0_00000000_01010000
0_00000000_01010001
0_00000000_01010010
0_00000000_01010011
0_00000000_01010100
0_00000000_01010101
0_00000000_01010110
0_00000000_01010111
0_00000000_01011000
0_00000000_01011001
0_00000000_01011010
0_00000000_01011011
0_00000000_01011100
0_00000000_01011101
1_00000000_00000000
0_00000000_01011110
0_00000000_01011111
0_00000000_01100000
0_00000000_01100001
0_00000000_01100010
0_00000000_01100011
0_00000000_01100100
0_00000000_01100101
0_00000000_01100110
0_00000000_01100111
0_00000000_01101000
0_00000000_01101001
0_00000000_01101010
0_00000000_01101011
0_00000000_01101100
0_00000000_01101101
0_00000000_01101110
0_00000000_01101111
0_00000000_01110000
0_00000000_01110001
0_00000000_01110010
0_00000000_01110011
0_00000000_01110100
0_00000000_01110101
0_00000000_01110110
0_00000000_01110111
0_00000000_01111000
0_00000000_01111001
0_00000000_01111010
0_00000000_01111011
0_00000000_01111100
0_00000000_01111101
0_00000000_01111110
0_00000000_01111111
0_00000000_10000000
0_00000000_10000001
0_00000000_10000010
0_00000000_10000011
0_00000000_10000100
0_00000000_10000101
0_00000000_10000110
0_00000000_10000111
0_00000000_10001000
0_00000000_10001001
0_00000000_10001010
0_00000000_10001011
0_00000000_10001100
0_00000000_10001101
1_00000000_00000000
0_00000000_10001110
0_00000000_10001111
1_00000000_00000000
0_00000000_10010000
1_00000000_00000000
0_00000000_10010001
0_00000000_10010010
0_00000000_10010011
1_00000000_00000000
0_00000000_10010100
0_00000000_10010101
0_00000000_10010110
0_00000000_10010111
0_00000000_10011000
1_00000000_00000000
0_00000000_10011001
0_00000000_10011010
0_00000000_10011011
0_00000000_10011100
0_00000000_10011101
0_00000000_10011110
0_00000000_10011111
0_00000000_10100000
0_00000000_10100001
0_00000000_10100010
0_00000000_10100011
0_00000000_10100100
0_00000000_10100101
0_00000000_10100110
0_00000000_10100111
0_00000000_10101000
0_00000000_10101001
0_00000000_10101010
0_00000000_10101011
0_00000000_10101100
0_00000000_10101101
0_00000000_10101110
0_00000000_10101111
0_00000000_10110000
0_00000000_10110001
0_00000000_10110010
0_00000000_10110011
0_00000000_10110100
0_00000000_10110101
0_00000000_10110110
0_00000000_10110111
0_00000000_10111000
