0_00000000_0000
0_00000000_0001
0_00000000_0010
0_00000000_0011
0_00000000_0100
0_00000000_0101
0_00000000_0110
0_00000000_0111
0_00000000_1000
0_00000000_1001
0_00000000_1010
0_00000000_1011
0_00000000_1100
0_00000000_1101
1_00000000_0000
1_00000000_0000
